



             #########
            ##       ##
           ##   ##    ##
        ####          ##
       $#####         ##
            ##       ##
             #     ###
            #  ######        ##################
           #########     #######         #############
          #####   ##  ####                        ######
         ##        ####                ############
        ##          #####################
        ##           ######            ##########
         #     #########                     #######
         #######                                  #####
          #                                         ###
          ######                                  ####
            #########################           ####
                ##################################
